-1,1:3,1:7,7,2,2,2,0,7,7,7
-1,1:1,-1:7,0,7,2,1,5,7,7,7
1,-1:3,1:7,1,7,1,6,3,7,0,5
-1,1:3,2:3,1,4,0,5,7,7,6,2
0,3:2,-1:3,4,0,1,5,1,1,6,7
3,0:3,1:2,2,2,3,0,2,6,7,7
-1,1:3,2:7,4,7,2,0,7,6,2,7
1,3:1,-1:3,2,4,1,0,1,6,2,5